4 4 2 2 5 3 5 4 1 2 4 4 6 1 3 0
2 4 2 2 5 3 5 4 1 2 4 4 2 1 3 3
1 4 2 2 6 3 5 4 2 0 4 4 3 1 3 3
4 4 2 5 5 3 5 4 1 1 4 4 3 1 3 3
7 4 2 4 5 3 5 4 2 0 4 4 6 1 3 3
4 4 0 2 5 3 5 4 2 1 4 0 6 1 3 2
3 4 2 2 5 3 5 4 3 0 4 4 6 1 3 5
4 4 2 2 5 3 5 4 2 2 4 4 5 1 3 1
8 4 2 7 5 6 5 4 4 0 4 4 5 1 3 3
4 4 2 2 5 3 5 4 6 2 1 4 4 1 3 5
4 0 2 2 5 3 5 4 2 2 4 4 8 1 3 3
4 4 2 2 5 3 5 4 2 5 4 4 1 1 3 4